ID		XNode		YNode		WidthNode		HeightNode		ChildNodeCount		ObjectsCount		ChildsIndex
0		0		0		1146				1146				4		0		
01		0		0		573				573				0		0		
02		573		0		573				573				0		0		
03		0		573		573				573				4		0		
031		0		573		286				286				0		0		
032		286		573		286				286				0		0		
033		0		859		286				286				4		0		
0331		0		859		143				143				0		0		
0332		143		859		143				143				0		0		
0333		0		1002		143				143				0		9		20		21		25		26		29		33		34		38		41		
0334		143		1002		143				143				0		10		14		15		16		22		26		30		35		42		45		47		
034		286		859		286				286				4		0		
0341		286		859		143				143				0		1		70		
0342		429		859		143				143				0		1		70		
0343		286		1002		143				143				0		11		10		11		12		14		23		27		31		36		39		43		70		
0344		429		1002		143				143				0		11		0		3		6		9		10		17		49		52		55		58		70		
04		573		573		573				573				4		0		
041		573		573		286				286				0		0		
042		859		573		286				286				0		0		
043		573		859		286				286				4		0		
0431		573		859		143				143				0		0		
0432		716		859		143				143				0		0		
0433		573		1002		143				143				0		11		24		28		32		37		40		44		46		58		61		62		71		
0434		716		1002		143				143				0		11		1		4		7		13		46		48		63		64		65		66		72		
044		859		859		286				286				4		0		
0441		859		859		143				143				0		1		73		
0442		1002		859		143				143				0		0		
0443		859		1002		143				143				0		10		4		8		18		50		53		56		59		67		68		69		
0444		1002		1002		143				143				0		8		2		5		8		19		51		54		57		60		
